##########################################################.........###############################################
#.......................................................##...........................########...........####.......##########......#
#.......................................................##...........................###############################################
#.........########...........####.......##########......##...........................###############################################
##########################################################..........#######...........####.......##########......#
##########################################################.....@....#............................................#
#.......................................................##########################################################
#.........########...........####.......##########......##########################################################
#########################################################
#########################################################
#.......................................................#
#.........########...........####.......##########......#
########################################################