##################################################################################################################
#.....@.................................................##.........########...........####.......##########......#
#.....@.................................................##########################################################
#.........########...........####.......##########......##########################################################
##########################################################.........########...........####.......##########......#
##########################################################.....@.................................................#
#.....@.................................................##########################################################
#.........########...........####.......##########......##########################################################
#########################################################
#########################################################
#.....@.................................................#
#.........########...........####.......##########......#
########################################################