##########################################################.........###############################################
#.......................................................##.........########...........####.......##########......#
#.......................................................##.........###############################################
#.........########...........####.......##########......##.........###############################################
##########################################################.........########...........####.......##########......#
##########################################################.....@....#............................................#
#.......................................................##########################################################
#.........########...........####.......##########......##########################################################
#########################################################
#########################################################
#.......................................................#
#.........########...........####.......##########......#
########################################################