##################################################################################################################
#.......................................................##.........########...........####.......##########......#
#.......................................................##########################################################
#.........########...........####.......##########......##########################################################
##########################################################.........########...........####.......##########......#
##########################################################.....@.................................................#
#.......................................................##########################################################
#.........########...........####.......##########......##########################################################
#########################################################
#########################################################
#.......................................................#
#.........########...........####.......##########......#
########################################################